############################
#............##............#
#.####.#####.##.#####.####.#
#P#  #.#   #.##.#   #.#  #.#
#.####.#####.##.#####.####.#
#..........................#
#.####.##.########.##.####.#
#......##....##....##......#
######.##### ## #####.######
     #.#   # ## #   #.#     
######.# # # ## # # #.######
     #.# # # G# # # #.#     
######.# # # ## # # #.######
     #.#   # ## #   #.#     
######.##### ## #####.######
#......##....##....##......#
#.####.##.########.##.####.#
#..........................#
############################
